11111111111111111111111111111111111111111
1000101010111110100000010000000C010000111
10000C00001111101000000100000000110000011
11000000011000000110000000101111001100011
11E100010000000100100000010000001C0000101
1101001000001010000001000000000C00000C001
1000000P10001000100100C00100110000000C001
11111111111111111111111111111111111111111
