1111111111111111111111111
1C0000E0000P0000C000C0001
1111111111111111111111111