11111111111111111111
1P000000C00111100111
10C0010010010011C001
10000000010111110001
11010110100110000011
100110100000C0010011
11001110110001010001
11100010011110010001
10110010111011110111
11111110110000010001
11C00000101011110101
11101110000000010111
10000010000000000011
110011010000000000C1
110C1111100000100001
10C00000000000000001
111101001110000000E1
11100100000000101001
10011011111001010011
11111111111111111111
